Dendroctonus_ponderosae	Coleoptera
Meloe_violaceus	Coleoptera
TRIBOLIUM_CASTANEUM	Coleoptera
Aleochara_curtula	Coleoptera
Lepicerus_sp	Coleoptera
Priacma_serrata	Coleoptera
Carabus_granulatus	Coleoptera
Gyrinus_marinus	Coleoptera
Conwentzia_psociformis	Neuropterida
Xanthostigma_xanthostigma	Neuropterida
Inocellia_crassicornis	Neuropterida
Corydalus_cornutus	Neuropterida
Sialis_lutaria	Neuropterida
Osmylus_fulvicephalus	Neuropterida
Euroleon_nostras	Neuropterida
Dichochrysa_prasina	Neuropterida
Hydroptilidae_sp	Trichoptera
Rhyacophila_fasciata	Trichoptera
Platycentropus_radiatus	Trichoptera
Cheumatopsyche_sp	Trichoptera
Philopotamus_ludificatus	Trichoptera
Micropterix_calthella	Lepidoptera
Eriocrania_subpurpurella	Lepidoptera
Triodia_sylvina	Lepidoptera
Nemophora_deegerella	Lepidoptera
Yponomeuta_evonymella	Lepidoptera
Zygaena_fausta	Lepidoptera
BOMBYX_MORI	Lepidoptera
Manduca_sexta	Lepidoptera
Parides_arcas	Lepidoptera
Polyommatus_icarus	Lepidoptera
Ceratophyllus_gallinae	Siphonaptera
Ctenocephalides_felis	Siphonaptera
Archaeopsylla_erinacei	Siphonaptera
Nannochorista_philpotti	Mecoptera
Boreus_hyemalis	Mecoptera
Panorpa_vulgaris	Mecoptera
Bittacus_pilicornis	Mecoptera
ANOPHELES_GAMBIAE	Diptera
Aedes_AEGYpti	Diptera
Phlebotomus_papatasi	Diptera
Bibio_marci	Diptera
Trichocera_fuscata	Diptera
Tipula_maxima	Diptera
Bombylius_major	Diptera
DROSOPHILA_MELANOGASTER	Diptera
Lipara_lucens	Diptera
Rhagoletis_pomonella	Diptera
Glossina_morsitans	Diptera
Triarthria_setipennis	Diptera
Sarcophaga_crassipalpis	Diptera
Stylops_melittae	Strepsiptera
Mengenilla_moldrzyki	Strepsiptera
Tenthredo_koehleri	Hymenoptera
Cotesia_vestalis	Hymenoptera
NASONIA_VITRIPENNIS	Hymenoptera
Leptopilina_clavipes	Hymenoptera
Orussus_abietinus	Hymenoptera
Chrysis_viridula	Hymenoptera
ACROMYRMEX_ECHINATIOR	Hymenoptera
Harpegnathos_SALTator	Hymenoptera
Exoneura_robusta	Hymenoptera
Bombus_terrestris	Hymenoptera
APIS_MELLIFERA	Hymenoptera
Ectopsocus_briggsi	Psocodea
Liposcelis_bostrychophila	Psocodea
PEDICULUS_HUMANUS	Psocodea
Menopon_gallinae	Psocodea
Gynaikothrips_ficorum	Thysanoptera
Frankliniella_cephalica	Thysanoptera
Thrips_palmi	Thysanoptera
Acanthocasuarina_muellerianae	Hemiptera
Bemisia_tabaci	Hemiptera
Trialeurodes_vaporariorum	Hemiptera
Planococcus_citri	Hemiptera
Essigella_californica	Hemiptera
ACYRTOSIPHON_PISUM	Hemiptera
Aphis_gossypii	Hemiptera
Nilaparvata_lugens	Hemiptera
Xenophysella_greensladeae	Hemiptera
Cercopis_vulnerata	Hemiptera
Okanagana_villosa	Hemiptera
Velia_caprai	Hemiptera
Ranatra_linearis	Hemiptera
Notostira_elongata	Hemiptera
Acanthosoma_haemorrhoidale	Hemiptera
Baetis_pumilus	Ephemeroptera
Isonychia_bicolor	Ephemeroptera
Eurylophella_sp	Ephemeroptera
Ephemera_danica	Ephemeroptera
Machilis_hrabei	Archaeognatha/microcoryphia
Meinertellus_cundinamarcensis	Archaeognatha/microcoryphia
Occasjapyx_japonicus	Diplura
Campodea_augens	Diplura
Tetrodontophora_bielanensis	Collembola
Anurida_maritima	Collembola
Sminthurus_vir_nig	Collembola
Folsomia_candida	Collembola
Pogonognathellus_lon_fla	Collembola
Acerentomon_sp	Protura
Speleonectes_tulumensis	Outgroup
DAPHNIA_PULEX	Outgroup
IXODES_SCAPULARIS	Outgroup
Glomeris_pustulata	Outgroup
Symphylella_vulgaris	Outgroup
Cypridininae_sp	Outgroup
Lepeophtheirus_salmonis	Outgroup
Sarsinebalia_urgorii	Outgroup
Litopenaeus_vannamei	Outgroup
Celuca_puligator	Outgroup
Calopteryx_splendens	Odonata
Cordulegaster_boltonii	Odonata
Epiophlebia_superstes	Odonata
Tricholepidion_gertschi	Thysanura/zygentoma
Atelura_formicaria	Thysanura/zygentoma
Thermobia_domestica	Thysanura/zygentoma
Apachyus_charteceus	Dermaptera
Forficula_auricularia	Dermaptera
Zorotypus_caudelli	Zoraptera
Aposthonia_japonica	Embiidina
Haploembia_palaui	Embiidina
Timema_cristinae	Phasmida/phasmatodea
Aretaon_asperrimus	Phasmida/phasmatodea
Peruphasma_schultei	Phasmida/phasmatodea
Perla_marginata	Plecoptera
Leuctra_sp	Plecoptera
Cosmioperla_kuna	Plecoptera
Gryllotalpa_sp	Orthoptera
Ceuthophilus_sp	Orthoptera
Tetrix_subulata	Orthoptera
Stenobothrus_lineatus	Orthoptera
Prosarthria_teretrirostris	Orthoptera
Tanzaniophasma_sp	Mantophasmatodea
Galloisiana_yuasai	Grylloblattodea
Grylloblatta_bifratrilecta	Grylloblattodea
Metallyticus_splendidus	Mantodea
Mantis_religiosa	Mantodea
Empusa_pennata	Mantodea
Blaberus_atropos	Blattodea
Periplaneta_americana	Blattodea
Cryptocercus_wrighti	Blattodea
Prorhinotermes_simplex	Blattodea
ZOOTERMOPSIS_NEVADENSIS	Blattodea
Mastotermes_darwiniensis	Blattodea
