Clade	Name	Clade	Definition	Section	Letter	Components	Comments
All	"Dendroctonus_ponderosae+""Meloe_violaceus""+""TRIBOLIUM_CASTANEUM""+""Aleochara_curtula""+""Lepicerus_sp""+""Priacma_serrata""+""Carabus_granulatus""+""Gyrinus_marinus""+""Conwentzia_psociformis""+""Xanthostigma_xanthostigma""+""Inocellia_crassicornis""+""Corydalus_cornutus""+""Sialis_lutaria""+""Osmylus_fulvicephalus""+""Euroleon_nostras""+""Dichochrysa_prasina""+""Hydroptilidae_sp""+""Rhyacophila_fasciata""+""Platycentropus_radiatus""+""Cheumatopsyche_sp""+""Philopotamus_ludificatus""+""Micropterix_calthella""+""Eriocrania_subpurpurella""+""Triodia_sylvina""+""Nemophora_deegerella""+""Yponomeuta_evonymella""+""Zygaena_fausta""+""BOMBYX_MORI""+""Manduca_sexta""+""Parides_arcas""+""Polyommatus_icarus""+""Ceratophyllus_gallinae""+""Ctenocephalides_felis""+""Archaeopsylla_erinacei""+""Nannochorista_philpotti""+""Boreus_hyemalis""+""Panorpa_vulgaris""+""Bittacus_pilicornis""+""ANOPHELES_GAMBIAE""+""Aedes_AEGYpti""+""Phlebotomus_papatasi""+""Bibio_marci""+""Trichocera_fuscata""+""Tipula_maxima""+""Bombylius_major""+""DROSOPHILA_MELANOGASTER""+""Lipara_lucens""+""Rhagoletis_pomonella""+""Glossina_morsitans""+""Triarthria_setipennis""+""Sarcophaga_crassipalpis""+""Stylops_melittae""+""Mengenilla_moldrzyki""+""Tenthredo_koehleri""+""Cotesia_vestalis""+""NASONIA_VITRIPENNIS""+""Leptopilina_clavipes""+""Orussus_abietinus""+""Chrysis_viridula""+""ACROMYRMEX_ECHINATIOR""+""Harpegnathos_SALTator""+""Exoneura_robusta""+""Bombus_terrestris""+""APIS_MELLIFERA""+""Ectopsocus_briggsi""+""Liposcelis_bostrychophila""+""PEDICULUS_HUMANUS""+""Menopon_gallinae""+""Gynaikothrips_ficorum""+""Frankliniella_cephalica""+""Thrips_palmi""+""Acanthocasuarina_muellerianae""+""Bemisia_tabaci""+""Trialeurodes_vaporariorum""+""Planococcus_citri""+""Essigella_californica""+""ACYRTOSIPHON_PISUM""+""Aphis_gossypii""+""Nilaparvata_lugens""+""Xenophysella_greensladeae""+""Cercopis_vulnerata""+""Okanagana_villosa""+""Velia_caprai""+""Ranatra_linearis""+""Notostira_elongata""+""Acanthosoma_haemorrhoidale""+""Baetis_pumilus""+""Isonychia_bicolor""+""Eurylophella_sp""+""Ephemera_danica""+""Machilis_hrabei""+""Meinertellus_cundinamarcensis""+""Occasjapyx_japonicus""+""Campodea_augens""+""Tetrodontophora_bielanensis""+""Anurida_maritima""+""Sminthurus_vir_nig""+""Folsomia_candida""+""Pogonognathellus_lon_fla""+""Acerentomon_sp""+""Speleonectes_tulumensis""+""DAPHNIA_PULEX""+""IXODES_SCAPULARIS""+""Glomeris_pustulata""+""Symphylella_vulgaris""+""Cypridininae_sp""+""Lepeophtheirus_salmonis""+""Sarsinebalia_urgorii""+""Litopenaeus_vannamei""+""Celuca_puligator""+""Calopteryx_splendens""+""Cordulegaster_boltonii""+""Epiophlebia_superstes""+""Tricholepidion_gertschi""+""Atelura_formicaria""+""Thermobia_domestica""+""Apachyus_charteceus""+""Forficula_auricularia""+""Zorotypus_caudelli""+""Aposthonia_japonica""+""Haploembia_palaui""+""Timema_cristinae""+""Aretaon_asperrimus""+""Peruphasma_schultei""+""Perla_marginata""+""Leuctra_sp""+""Cosmioperla_kuna""+""Gryllotalpa_sp""+""Ceuthophilus_sp""+""Tetrix_subulata""+""Stenobothrus_lineatus""+""Prosarthria_teretrirostris""+""Tanzaniophasma_sp""+""Galloisiana_yuasai""+""Grylloblatta_bifratrilecta""+""Metallyticus_splendidus""+""Mantis_religiosa""+""Empusa_pennata""+""Blaberus_atropos""+""Periplaneta_americana""+""Cryptocercus_wrighti""+""Prorhinotermes_simplex""+""ZOOTERMOPSIS_NEVADENSIS""+""Mastotermes_darwiniensis"""	None
Archaeognatha/microcoryphia	"Machilis_hrabei+""Meinertellus_cundinamarcensis"""	None
Blattodea	"Blaberus_atropos+""Periplaneta_americana""+""Cryptocercus_wrighti""+""Prorhinotermes_simplex""+""ZOOTERMOPSIS_NEVADENSIS""+""Mastotermes_darwiniensis"""	None
Coleoptera	"Dendroctonus_ponderosae+""Meloe_violaceus""+""TRIBOLIUM_CASTANEUM""+""Aleochara_curtula""+""Lepicerus_sp""+""Priacma_serrata""+""Carabus_granulatus""+""Gyrinus_marinus"""	None
Collembola	"Tetrodontophora_bielanensis+""Anurida_maritima""+""Sminthurus_vir_nig""+""Folsomia_candida""+""Pogonognathellus_lon_fla"""	None
Dermaptera	"Apachyus_charteceus+""Forficula_auricularia"""	None
Diplura	"Occasjapyx_japonicus+""Campodea_augens"""	None
Diptera	"ANOPHELES_GAMBIAE+""Aedes_AEGYpti""+""Phlebotomus_papatasi""+""Bibio_marci""+""Trichocera_fuscata""+""Tipula_maxima""+""Bombylius_major""+""DROSOPHILA_MELANOGASTER""+""Lipara_lucens""+""Rhagoletis_pomonella""+""Glossina_morsitans""+""Triarthria_setipennis""+""Sarcophaga_crassipalpis"""	None
Embiidina	"Aposthonia_japonica+""Haploembia_palaui"""	None
Ephemeroptera	"Baetis_pumilus+""Isonychia_bicolor""+""Eurylophella_sp""+""Ephemera_danica"""	None
Grylloblattodea	"Galloisiana_yuasai+""Grylloblatta_bifratrilecta"""	None
Hemiptera	"Acanthocasuarina_muellerianae+""Bemisia_tabaci""+""Trialeurodes_vaporariorum""+""Planococcus_citri""+""Essigella_californica""+""ACYRTOSIPHON_PISUM""+""Aphis_gossypii""+""Nilaparvata_lugens""+""Xenophysella_greensladeae""+""Cercopis_vulnerata""+""Okanagana_villosa""+""Velia_caprai""+""Ranatra_linearis""+""Notostira_elongata""+""Acanthosoma_haemorrhoidale"""	None
Hymenoptera	"Tenthredo_koehleri+""Cotesia_vestalis""+""NASONIA_VITRIPENNIS""+""Leptopilina_clavipes""+""Orussus_abietinus""+""Chrysis_viridula""+""ACROMYRMEX_ECHINATIOR""+""Harpegnathos_SALTator""+""Exoneura_robusta""+""Bombus_terrestris""+""APIS_MELLIFERA"""	None
Lepidoptera	"Micropterix_calthella+""Eriocrania_subpurpurella""+""Triodia_sylvina""+""Nemophora_deegerella""+""Yponomeuta_evonymella""+""Zygaena_fausta""+""BOMBYX_MORI""+""Manduca_sexta""+""Parides_arcas""+""Polyommatus_icarus"""	None
Mantodea	"Metallyticus_splendidus+""Mantis_religiosa""+""Empusa_pennata"""	None
Mantophasmatodea	"Tanzaniophasma_sp"""	None
Mecoptera	"Nannochorista_philpotti+""Boreus_hyemalis""+""Panorpa_vulgaris""+""Bittacus_pilicornis"""	None
Neuropterida	"Conwentzia_psociformis+""Xanthostigma_xanthostigma""+""Inocellia_crassicornis""+""Corydalus_cornutus""+""Sialis_lutaria""+""Osmylus_fulvicephalus""+""Euroleon_nostras""+""Dichochrysa_prasina"""	None
Odonata	"Calopteryx_splendens+""Cordulegaster_boltonii""+""Epiophlebia_superstes"""	None
Orthoptera	"Gryllotalpa_sp+""Ceuthophilus_sp""+""Tetrix_subulata""+""Stenobothrus_lineatus""+""Prosarthria_teretrirostris"""	None
Outgroup	"Speleonectes_tulumensis+""DAPHNIA_PULEX""+""IXODES_SCAPULARIS""+""Glomeris_pustulata""+""Symphylella_vulgaris""+""Cypridininae_sp""+""Lepeophtheirus_salmonis""+""Sarsinebalia_urgorii""+""Litopenaeus_vannamei""+""Celuca_puligator"""	None
Phasmida/phasmatodea	"Timema_cristinae+""Aretaon_asperrimus""+""Peruphasma_schultei"""	None
Plecoptera	"Perla_marginata+""Leuctra_sp""+""Cosmioperla_kuna"""	None
Protura	"Acerentomon_sp"""	None
Psocodea	"Ectopsocus_briggsi+""Liposcelis_bostrychophila""+""PEDICULUS_HUMANUS""+""Menopon_gallinae"""	None
Siphonaptera	"Ceratophyllus_gallinae+""Ctenocephalides_felis""+""Archaeopsylla_erinacei"""	None
Strepsiptera	"Stylops_melittae+""Mengenilla_moldrzyki"""	None
Thysanoptera	"Gynaikothrips_ficorum+""Frankliniella_cephalica""+""Thrips_palmi"""	None
Thysanura/zygentoma	"Tricholepidion_gertschi+""Atelura_formicaria""+""Thermobia_domestica"""	None
Trichoptera	"Hydroptilidae_sp+""Rhyacophila_fasciata""+""Platycentropus_radiatus""+""Cheumatopsyche_sp""+""Philopotamus_ludificatus"""	None
Zoraptera	"Zorotypus_caudelli"""	None
Mecoptera/Siphonaptera	Siphonaptera+Mecoptera	None	Siphonaptera+Mecoptera
Diptera/Mecoptera/Siphonaptera	Mecoptera/Siphonaptera+Diptera	None	Mecoptera/Siphonaptera+Diptera
Trichoptera/Lepidoptera	Lepidoptera+Trichoptera	None	Lepidoptera+Trichoptera
Diptera/Mecoptera/Siphonaptera/Trichoptera/Lepidoptera	Trichoptera/Lepidoptera+Diptera/Mecoptera/Siphonaptera	None	Trichoptera/Lepidoptera+Diptera/Mecoptera/Siphonaptera
Strepsiptera/Neuropterida/Coleoptera	Coleoptera+Strepsiptera+Neuropterida	None	Coleoptera+Strepsiptera+Neuropterida
Strepsiptera/Neuropterida/Coleoptera/Diptera/Mecoptera/Siphonaptera/Trichoptera/Lepidoptera	Diptera/Mecoptera/Siphonaptera/Trichoptera/Lepidoptera+Strepsiptera/Neuropterida/Coleoptera	None	Diptera/Mecoptera/Siphonaptera/Trichoptera/Lepidoptera+Strepsiptera/Neuropterida/Coleoptera
Hymenoptera/Strepsiptera/Neuropterida/Coleoptera/Diptera/Mecoptera/Siphonaptera/Trichoptera/Lepidoptera	Strepsiptera/Neuropterida/Coleoptera/Diptera/Mecoptera/Siphonaptera/Trichoptera/Lepidoptera+Hymenoptera	None	Strepsiptera/Neuropterida/Coleoptera/Diptera/Mecoptera/Siphonaptera/Trichoptera/Lepidoptera+Hymenoptera
Hemiptera/Thysanoptera	Thysanoptera+Hemiptera	None	Thysanoptera+Hemiptera
Hemiptera/Thysanoptera/Psocodea/Hymenoptera/Strepsiptera/Neuropterida/Coleoptera/Diptera/Mecoptera/Siphonaptera/Trichoptera/Lepidoptera	Hymenoptera/Strepsiptera/Neuropterida/Coleoptera/Diptera/Mecoptera/Siphonaptera/Trichoptera/Lepidoptera+Hemiptera/Thysanoptera+Psocodea	None	Hymenoptera/Strepsiptera/Neuropterida/Coleoptera/Diptera/Mecoptera/Siphonaptera/Trichoptera/Lepidoptera+Hemiptera/Thysanoptera+Psocodea
Grylloblattodea/Mantophasmatodea	Mantophasmatodea+Grylloblattodea	None	Mantophasmatodea+Grylloblattodea
Grylloblattodea/Mantophasmatodea/Phasmida/phasmatodea/Embiidina	Embiidina+Phasmida/phasmatodea+Grylloblattodea/Mantophasmatodea	None	Embiidina+Phasmida/phasmatodea+Grylloblattodea/Mantophasmatodea
Blattodea/Orthoptera/Plecoptera/Mantodea/Zoraptera/Dermaptera/Grylloblattodea/Mantophasmatodea/Phasmida/phasmatodea/Embiidina	Grylloblattodea/Mantophasmatodea/Phasmida/phasmatodea/Embiidina+Blattodea+Orthoptera+Plecoptera+Mantodea+Zoraptera+Dermaptera	None	Grylloblattodea/Mantophasmatodea/Phasmida/phasmatodea/Embiidina+Blattodea+Orthoptera+Plecoptera+Mantodea+Zoraptera+Dermaptera
Hemiptera/Thysanoptera/Psocodea/Hymenoptera/Strepsiptera/Neuropterida/Coleoptera/Diptera/Mecoptera/Siphonaptera/Trichoptera/Lepidoptera/Blattodea/Orthoptera/Plecoptera/Mantodea/Zoraptera/Dermaptera/Grylloblattodea/Mantophasmatodea/Phasmida/phasmatodea/Embiidina	Blattodea/Orthoptera/Plecoptera/Mantodea/Zoraptera/Dermaptera/Grylloblattodea/Mantophasmatodea/Phasmida/phasmatodea/Embiidina+Hemiptera/Thysanoptera/Psocodea/Hymenoptera/Strepsiptera/Neuropterida/Coleoptera/Diptera/Mecoptera/Siphonaptera/Trichoptera/Lepidoptera	None	Blattodea/Orthoptera/Plecoptera/Mantodea/Zoraptera/Dermaptera/Grylloblattodea/Mantophasmatodea/Phasmida/phasmatodea/Embiidina+Hemiptera/Thysanoptera/Psocodea/Hymenoptera/Strepsiptera/Neuropterida/Coleoptera/Diptera/Mecoptera/Siphonaptera/Trichoptera/Lepidoptera
Ephemeroptera/Odonata/Hemiptera/Thysanoptera/Psocodea/Hymenoptera/Strepsiptera/Neuropterida/Coleoptera/Diptera/Mecoptera/Siphonaptera/Trichoptera/Lepidoptera/Blattodea/Orthoptera/Plecoptera/Mantodea/Zoraptera/Dermaptera/Grylloblattodea/Mantophasmatodea/Phasmida/phasmatodea/Embiidina	Hemiptera/Thysanoptera/Psocodea/Hymenoptera/Strepsiptera/Neuropterida/Coleoptera/Diptera/Mecoptera/Siphonaptera/Trichoptera/Lepidoptera/Blattodea/Orthoptera/Plecoptera/Mantodea/Zoraptera/Dermaptera/Grylloblattodea/Mantophasmatodea/Phasmida/phasmatodea/Embiidina+Ephemeroptera+Odonata	None	Hemiptera/Thysanoptera/Psocodea/Hymenoptera/Strepsiptera/Neuropterida/Coleoptera/Diptera/Mecoptera/Siphonaptera/Trichoptera/Lepidoptera/Blattodea/Orthoptera/Plecoptera/Mantodea/Zoraptera/Dermaptera/Grylloblattodea/Mantophasmatodea/Phasmida/phasmatodea/Embiidina+Ephemeroptera+Odonata
Thysanura/zygentoma/Ephemeroptera/Odonata/Hemiptera/Thysanoptera/Psocodea/Hymenoptera/Strepsiptera/Neuropterida/Coleoptera/Diptera/Mecoptera/Siphonaptera/Trichoptera/Lepidoptera/Blattodea/Orthoptera/Plecoptera/Mantodea/Zoraptera/Dermaptera/Grylloblattodea/Mantophasmatodea/Phasmida/phasmatodea/Embiidina	Ephemeroptera/Odonata/Hemiptera/Thysanoptera/Psocodea/Hymenoptera/Strepsiptera/Neuropterida/Coleoptera/Diptera/Mecoptera/Siphonaptera/Trichoptera/Lepidoptera/Blattodea/Orthoptera/Plecoptera/Mantodea/Zoraptera/Dermaptera/Grylloblattodea/Mantophasmatodea/Phasmida/phasmatodea/Embiidina+Thysanura/zygentoma	None	Ephemeroptera/Odonata/Hemiptera/Thysanoptera/Psocodea/Hymenoptera/Strepsiptera/Neuropterida/Coleoptera/Diptera/Mecoptera/Siphonaptera/Trichoptera/Lepidoptera/Blattodea/Orthoptera/Plecoptera/Mantodea/Zoraptera/Dermaptera/Grylloblattodea/Mantophasmatodea/Phasmida/phasmatodea/Embiidina+Thysanura/zygentoma
Archaeognatha/microcoryphia/Thysanura/zygentoma/Ephemeroptera/Odonata/Hemiptera/Thysanoptera/Psocodea/Hymenoptera/Strepsiptera/Neuropterida/Coleoptera/Diptera/Mecoptera/Siphonaptera/Trichoptera/Lepidoptera/Blattodea/Orthoptera/Plecoptera/Mantodea/Zoraptera/Dermaptera/Grylloblattodea/Mantophasmatodea/Phasmida/phasmatodea/Embiidina	Thysanura/zygentoma/Ephemeroptera/Odonata/Hemiptera/Thysanoptera/Psocodea/Hymenoptera/Strepsiptera/Neuropterida/Coleoptera/Diptera/Mecoptera/Siphonaptera/Trichoptera/Lepidoptera/Blattodea/Orthoptera/Plecoptera/Mantodea/Zoraptera/Dermaptera/Grylloblattodea/Mantophasmatodea/Phasmida/phasmatodea/Embiidina+Archaeognatha/microcoryphia	None	Thysanura/zygentoma/Ephemeroptera/Odonata/Hemiptera/Thysanoptera/Psocodea/Hymenoptera/Strepsiptera/Neuropterida/Coleoptera/Diptera/Mecoptera/Siphonaptera/Trichoptera/Lepidoptera/Blattodea/Orthoptera/Plecoptera/Mantodea/Zoraptera/Dermaptera/Grylloblattodea/Mantophasmatodea/Phasmida/phasmatodea/Embiidina+Archaeognatha/microcoryphia
Collembola/Diplura/Protura/Archaeognatha/microcoryphia/Thysanura/zygentoma/Ephemeroptera/Odonata/Hemiptera/Thysanoptera/Psocodea/Hymenoptera/Strepsiptera/Neuropterida/Coleoptera/Diptera/Mecoptera/Siphonaptera/Trichoptera/Lepidoptera/Blattodea/Orthoptera/Plecoptera/Mantodea/Zoraptera/Dermaptera/Grylloblattodea/Mantophasmatodea/Phasmida/phasmatodea/Embiidina	Archaeognatha/microcoryphia/Thysanura/zygentoma/Ephemeroptera/Odonata/Hemiptera/Thysanoptera/Psocodea/Hymenoptera/Strepsiptera/Neuropterida/Coleoptera/Diptera/Mecoptera/Siphonaptera/Trichoptera/Lepidoptera/Blattodea/Orthoptera/Plecoptera/Mantodea/Zoraptera/Dermaptera/Grylloblattodea/Mantophasmatodea/Phasmida/phasmatodea/Embiidina+Collembola+Diplura+Protura	None	Archaeognatha/microcoryphia/Thysanura/zygentoma/Ephemeroptera/Odonata/Hemiptera/Thysanoptera/Psocodea/Hymenoptera/Strepsiptera/Neuropterida/Coleoptera/Diptera/Mecoptera/Siphonaptera/Trichoptera/Lepidoptera/Blattodea/Orthoptera/Plecoptera/Mantodea/Zoraptera/Dermaptera/Grylloblattodea/Mantophasmatodea/Phasmida/phasmatodea/Embiidina+Collembola+Diplura+Protura
